[這是空白]
cpo - micpo enlever l'écorce.
cpo' - misacpo' rite Amis : souvent au troisième jour des ilisin, pour obtenir du poisson. Dans  beaucoup de villages, le "finawlan" se réunit à l'embouchure d'une rivière; le rite païen ou chrétien selon  les lieux. a Iieu vers 21h.; puis c'est le repas des poissons par classes d'âges; accompagnent ou suivent les  discours, ensuite courses par classes d'âges. - Ailleurs cette journée s'appelle Miladis ou Mikomoris — un  mois environ avant les moissons. A. B..
cpo' - pacpo'an trappe à poissons : endroit d'une rivière fermée par une trappe pour prendre les  poissons.
cra' = sga' avoir le dégoût de ; avoir la nausée; être tiré; être poussé; antipathie.
cra' - macra' ennuyé; en avoir assez; être lassé.
cradad = cadada étagère.
cradaday = masacadadaay en corniche.
[這是空白]
crahad - micrahad = clahad souffler...
crahadan — {S} trop plein.
crai' ='imcday flexible.
'crak micrak {N} _ pulluler.
crak - mocrak {Z} grandir.
crar = prar glissement de terrain.
crar - macrar ko lotok grand éboulement en montagne.
cras éclat de bois.
cras — micras {N} = cli’ appeler.
cred groupe du même âge: Personne du même nom: Le cred dans la région de Fakog est celui ou  celle qut porte le même nom : ex. Kolas, homme ou femme, enfant ou adulte . Cela crée un lien d'amitié. A.
cregay - pacregay cohabitation: homme qui habite avec la fille de la maison, les parents ayant donné leur consentement.
cren - micren {F} = clem s'enfoncer.
[這是空白]
crid - macrid suffisant.
crig barrage de bambous: barrage fait avec des bambous pour empêcher les poissons de sortir d'un  étang.
crik - micrik = clik crépiter.
cris - micris = kris gratter; fourbir (frotter): (allumettes, briquet).
crit - micrit = krit déchirer.
crnoh - macrnoh avoir la chair de poule: (de frayeur) - les cheveux qui se dressent sur la tête.  crocrot - caay pacrocrot sans- réponse.
crod - macrod humidifié: macrod no lahod : humidifié par la vapeur.
czoh=cloh ajouter; sucer, aspirer; augmenter; Chun Jih village: Hualien hsien, Yü Li chen.
[圖片不清楚]
[這是空白]
cror - micror, papicror prendre la place de : (travail, poste responsable) ; succéder: "Pala
hogti ako ko ccay no tloc iso a papicror tisowanan"A.A. 2.30 (Dieu avait juré à David) Je ferai asseoir sur
ton trône un descendant de ton sang - Papicror han iso kako to mama ako a pala hogti. " 1 R.3.7 Tu as  établi roi ton serviteur à la place de mon père.
cros ressort.
cros - micros jaillir (jet de vapeur) : Micros ko lahod no sra: l'humidité du sol ressort - Micros ko  fa’det nira: il a des poussées de fièvre.
cyofo - {J} tuyau intérieur; chambre à air (vélo..).  cyomig - {J} carnet de notes; certificat; attestation
[這是空白]
crig
