toloc - pakatoloc = pakatloc 339 tomoh - matomoh {Z} = matomostos
tOIOC - pakatoloc = pakatloc demier-né; rejeton.
tolod — mitolod {S} rouler (pour un parchemin).
toloho = tloho' mollard; gros crachat.
tolok faisan au cou annelé.
tolon prier ——; porter un commandement (une requête) à un autre —; faireune  commission.dire delapartdequelqu'un : opitolon ko ga’ayay.' le mieux est de prier — 0 maan k0  tatolonen ° Quelle prière Î’. _
tolon - patolon donner une commission. une consigne ; testament : patolon cigra m sowa]  takoivanan: il m'a apporté le message qui m'est destine’.
toloy - mitoloy {Z ensemble.
toltol - matoltol { } = mastol buter du pied.
tomad - mitomad t0 fa|oco' = mifalic puridier. transformer.
tomadaw venir en aide; assister : Mitomadawtty: (assister les_frères — "ll/Iitomadztw ko Tapag  takowanan, saka oaav pakagoda” Is 50/7 Le Seigneur vient à mon aide, c'est pourquoi je ne ressens pas les  outrages.
tomadaw - {S} examiner: inspecter ; contrôler (travail).
tomagic = tagic pleurer...
tomaî' = tai' aller à la selle : lirztomaiïzn: cabinet...
tomaliw = sopaliw changer de lace: être disponible (pour changer).
toman - <1> = kalotoman = ka alatoman = kalitomen avoir la chair de poule.
to'man - <2> ténèbres: sombre mrop et fig) : nzmaporoporog ko to’man: nuit noire — To’man  k0 lizvkziravan: le ciel est sombre, noir - To 'man ta ko romi’ad = o dadaya to: il sefait tard, Ie soir est là. —  Sa ro 'man saan: ilfait nuit — Sa to'n1anan saan: crépuscule - Sa to’manen ita ko Ialama’ Jfaisons la nuit à  l 'interieiti’ - l mahka ta 'man: a la tombée de la nuit - To'man ko pisig nira: son visage est sombre (triste  ou en colère).
to'manay enfer. lien de ténèbres.
tomato = kamamiay tomate : lycopersicum eseulantunz.
tomay ours --— : être féroce. violent.
Tomay Yen Liyao village: Hualien hsien — Shou Feng hsiang.
tomayi' = tomaî' aller à la selle.
tomcek = mocek regarder fixement: objectif. but .' patomocek sa cigra a santon/al
ffl/COWÛHÛH.' il regardefixement en me parlant — Icowa k0 patomcekan iso .7 quel est ton but — Cima ko  Icammcekan iso? pour qui refais-tu du souci 7 qui appuies-tu Î’.
tomdef - {T} = tomrep se taire
tomek paisible: calme...
tomes - matomes plein: complet: matomes ko kaysig: le bol est plein — Matomes no lipahak ko
faloco’ako: mon coeur est rempli de J012.
tomes - mitomes remplir.
tomfo = fcacido’ libellule.
tomîgac = tomlac = tlac manquer le but.
tomih - patomih {Z} accorder en rechignant.
tomiker = tiker réaliser.
tomili' = tomli' blanc.
tomireg = tireg se tenir debout: se dresser.
tomireg - katomireg debout !
tomiregan - katomiregan station (bus....).
tomiregan - tolas no katomiregan terminus.
tomirmir = o no 'oway a kawas dieu du rotin.
tomiti' - {F} = tari'ti' trembler...
tomiyac frapper"; heurter: ricocher ( rocher, pierre. balle, flèche ).  Tomiyac Chung An village: T aitung hsien, Ch’eng Kung hsiang.  tomiyac = tomlac = caay ka tatodog manquer; glisser à côte’ de.  tom ken = tomkeg = tkeg couler à pic: " Na matahpo no nanom, tomken cagra i talologay" Ex.  15/5 Les abîmes les recouvrent, ils sont descendus dans le gouffre comme une pierre.  tomlac manquer le but.
tom|i' = tmIi' = tmi|i' étinceler de blancheur; briller.
tomnek - {F} = tomken = totoh = tneg couler (bateau... ).  tomoa = tomowa ouvrir la bouche.
tomoh — matomoh {Z} = matomostos émoussé . non aigu.
